cyrillic	latin
пойабзал	poyabzal
пойабзалчи	poyabzalchi
пойабзалчилик	poyabzalchilik
пойафзал	poyafzal
пойандоз	poyandoz
генерал-майор	general-mayor
майонез	mayonez
майор	mayor
микрорайон	mikrorayon
район	rayon
йод	yod
ёд	yod
йодламоқ	yodlamoq
йодли	yodli
йог	yog
йога	yoga
йогурт	yogurt
мойупа	moyupa
пойустун	poyustun